wwwwwwwwwwwwwwwwwwww
w..................w
w..................w
w1.www........www..w
w..w............w..w
w..w............w..w
w..w............w..w
w..w............w..w
w..w............w..w
w..w............w..w
w..w............w..w
w..www........www.2w
w..................w
w..................w
wwwwwwwwwwwwwwwwwwww