wwwwwwwwwwwwwwwwwwww
w1.................w
w.wwwwwwwwwwwwwwww.w
w.w..............w.w
w.w...wwwwwwwww..w.w
w.....w.......w..w.w
w.....w.......w..w.w
w.w...........w..w.w
w.w...w.......w....w
w.w...w.......w....w
w.w...wwwwwwwww..w.w
w.w..............w.w
w.wwwwwwwwwwwwwwww.w
w.................2w
wwwwwwwwwwwwwwwwwwww